1 1 1 1 1 1 1 1 1 1 1 1 1 1 1 1 1 1 1 1 1 1 3 
1 6 1 6 1 1 1 1 1 1 1 6 1 1 6 2 2 1 1 1 1 1 3
1 2 2 2 1 6 2 1 1 1 2 2 2 1 1 1 2 2 2 6 1 1 3
1 2 1 1 1 1 2 1 1 1 2 1 2 1 1 1 2 1 1 1 1 1 3
1 2 2 2 1 1 2 2 2 2 2 1 2 2 2 2 2 2 2 2 6 1 3
1 2 1 1 1 1 1 1 1 1 2 1 1 1 2 1 1 2 1 1 1 1 3
1 2 1 1 1 1 1 1 1 1 2 1 1 1 2 1 1 2 2 2 2 2 3
1 2 2 2 2 2 2 2 1 2 2 2 1 1 2 2 2 2 1 2 1 2 3
1 1 1 1 1 1 1 2 1 2 1 2 1 1 1 1 2 1 1 2 1 5 3
1 1 1 1 2 2 2 2 1 2 1 2 2 1 1 1 2 1 1 2 1 1 3
1 1 1 1 1 1 1 2 1 2 1 1 2 1 1 1 1 1 1 2 1 1 3
1 1 2 2 2 2 2 2 2 2 2 1 2 2 2 2 2 2 2 2 2 1 3
1 1 2 1 1 2 1 1 1 1 2 1 1 1 1 2 1 1 2 1 2 1 3
1 1 2 1 1 2 2 2 1 1 2 2 2 2 2 2 1 1 2 1 2 1 3
1 1 2 1 1 1 1 2 1 1 2 1 1 1 2 1 1 1 2 1 2 1 3
1 1 2 1 1 1 1 2 2 2 2 2 2 1 2 1 1 2 6 1 2 1 3
1 1 4 2 1 1 1 1 2 1 1 1 2 1 2 1 1 2 1 1 2 1 3
1 1 1 2 2 2 2 2 2 2 1 2 2 1 2 2 2 2 6 1 2 5 3
1 1 1 1 2 1 2 1 2 1 1 2 1 1 2 1 1 2 1 2 1 1 3
1 1 1 1 1 1 1 1 1 1 1 1 1 1 1 1 1 1 1 1 1 1 3